%%%%%%%%%%%%%%%%%%%%%%%%%%%%%%%%%%%%%%%%%%%%%%%%%
%                                               %
%                                               %
%                                               %
%                                               %
%                                               %
%                                               %
%        %%%%%%%%%%%%%%%%%%%%%%%%%%%%%%%        %
%        %                             %        %
%        %                             %        %
%        %                             %        %
%        %                             %        %
%        %                             %        %
%        %                             %        %
%        %                             %        %
%        %                             %        %
%        %                             %        %
%        %                             %        %
%        %                             %        %
%        %                             %        %
%        %                             %        %
%        %                             %        %
%        %                             %        %
%        %                             %        %
%        %                             %        %
%        %                             %        %
%        %                             %        %
%        %                             %        %
%        %                             %        %
%        %                             %        %
%        %                             %        %
%        %                             %        %
%        %                             %        %
%        %                             %        %
%        %                             %        %
%        %                             %        %
%        %%%%%%%%%%%%%%%%%%%%%%%%%%%%%%%        %
%                      .%                       %
%                      .%                       %
%                      .%                       %
%                      .%                       %
%                      .%                       %
%                      .%  #                    %
%%%%%%%%%%%%%%%%%%%%%%%%%%%%%%%%%%%%%%%%%%%%%%%%%
