%%%%%%%%%%%%%%%%%%%%%%%%%%%%%%%%%%%%%%%%%%%%%%%%%%%%%%%%%%%%%%%%%%%%%%%%%%%%%%%%%%%%%%%%%%%%%%%%%%
%...............................................................................%................%
%...............................................................................%................%
%...............................................................................%................%
%...............................................................................%................%
%...............................................................................%................%
%...............................................................................%................%
%...............................................................................%................%
%...............................................................................%%%%%%%%%%%%%%%%%%
%................................................................................................%
%................................................................................................%
%................................................................................................%
%................................................................................................%
%................................................................................................%
%................................................................................................%
%................................................................................................%
%................................................................................................%
%................................................................................................%
%................................................................................................%
%................................................................................................%
%................................................................................................%
%................................................................................................%
%................................................................................................%
%................................................................................................%
%................................................................................................%
%................................................................................................%
%................................................................................................%
%................................................................................................%
%................................................................................................%
%.......#........................................................................................%
%%%%%%%%%%%%%%%%%%%%%%%%%%%%%%%%%%%%%%%%%%%%%%%%%%%%%%%%%%%%%%%%%%%%%%%%%%%%%%%%%%%%%%%%%%%%%%%%%%
