%%%%%%%%%%%%%%%%%%%%%%%%%%%%%%%%%%%%%%%
%                                     %
%                                     %
%                                     %
%                                     %
%                                     %
%                                     %
%                                     %
%                                     %
%                                     %
%                                     %
%           %%%%%%%%%%%%%%%           %
%           %             %           %
%           %             %           %
%           %             %           %
%           %             %           %
%           %             %           %
%           %             %           %
%           %             %           %
%           %             %           %
%           %             %           %
%           %             %           %
%           %%%%%%%%%%%%%%%           %
%                 .%                  %
%                 .%                  %
%                 .%                  %
%                 .%                  %
%                 .%                  %
%                 .%                  %
%                 .%                  %
%                 .%                  %
%                 .%                  %
%                 .%  #               %
%%%%%%%%%%%%%%%%%%%%%%%%%%%%%%%%%%%%%%%
