%%%%%%%%%
%.......%
%.......%
%%%%%%%%%
