%%%%%%%%%%%%%%%%%%%%
%                  %
%                  %
%  %%%%%%%%%%%%%%  %
%  %            %  %
%  %            %  %
%  %            %  %
%  %            %  %
%  %            %  %
%  %            %  %
%  %            %  %
%  %            %  %
%  %            %  %
%  %%%%%%%%%%%%%%  %
%       .%         %
%       .%  #      %
%%%%%%%%%%%%%%%%%%%%
