%%%%%%%%%%%%%%%%%%%%%%%%%%%%%%%%%%%%%%%%%%%%%%%%%%%%%%%%%%%%%%%%%%%%%%%%%%%%%%%%%%%%%%%%%%%%%%%%%%
%                                                                    %                           %
%                                                                    %                           %
%                                                                    %                           %
%                                                                    %                           %
%                                                                    %                           %
%                                                                    %                           %
%                                                                    %                           %
%                                                                    %                       #   %
%                                                                    %                           %
%                                                                    %%%%%%%%%%%%%%%%%%%%%%%%%%%%%
%                                                                                                %
%                                                                                                %
%                                                                                                %
%                                                                                                %
%                                                                                                %
%                                                                                                %
%                                                                                                %
%                                                                                                %
%                                                                                                %
%                                                                                                %
%                                                                                                %
%                                                                                                %
%                                                                                                %
%                                                                                                %
%                                                                                                %
%                                   .                                                            %
%                                   .                                                            %
%                                   .                                                            %
%                                   .                                                            %
%%%%%%%%%%%%%%%%%%%%%%%%%%%%%%%%%%%%%%%%%%%%%%%%%%%%%%%%%%%%%%%%%%%%%%%%%%%%%%%%%%%%%%%%%%%%%%%%%%
